BotData 3-5-800-1100-25-40-6500-11500-1
MODE 0
SIZE 11/30
LIMIT 0/15
COLOR LIMIT 3
STARS 1200/2500/4000
1 1 1 3 1 3 1 3 2 2 2
1 1 3 3 2 2 3 3 2 2 0
0 1 5 5 3 2 3 5 5 2 0
0 5 2 1 3 3 1 2 5 0 0
0 2 5 2 1 3 1 2 5 1 0
2 2 5 2 1 1 2 5 1 1 0
2 2 2 5 2 2 2 5 1 1 1
0 0 0 5 5 5 5 0 0 0 0
0 0 0 0 3 3 3 0 0 0 0
0 0 0 0 3 3 0 0 0 0 0
0 0 0 0 0 3 0 0 0 0 0
0 0 0 0 0 0 0 0 0 0 0
0 0 0 0 0 0 0 0 0 0 0
0 0 0 0 0 0 0 0 0 0 0
0 0 0 0 0 0 0 0 0 0 0
0 0 0 0 0 0 0 0 0 0 0
0 0 0 0 0 0 0 0 0 0 0
0 0 0 0 0 0 0 0 0 0 0
0 0 0 0 0 0 0 0 0 0 0
0 0 0 0 0 0 0 0 0 0 0
0 0 0 0 0 0 0 0 0 0 0
0 0 0 0 0 0 0 0 0 0 0
0 0 0 0 0 0 0 0 0 0 0
0 0 0 0 0 0 0 0 0 0 0
0 0 0 0 0 0 0 0 0 0 0
0 0 0 0 0 0 0 0 0 0 0
0 0 0 0 0 0 0 0 0 0 0
0 0 0 0 0 0 0 0 0 0 0
0 0 0 0 0 0 0 0 0 0 0
0 0 0 0 0 0 0 0 0 0 0