BotData 5-8-0-850-42-60-4200-11500-1
MODE 0
SIZE 11/30
LIMIT 0/25
COLOR LIMIT 5
STARS 1200/2200/3500
6 6 6 6 6 6 6 6 6 6 6
0 0 3 3 0 0 1 1 0 0 0
0 0 0 2 2 0 5 5 0 0 0
0 0 0 1 1 3 3 0 0 0 0
0 3 3 2 2 0 2 2 3 3 0
1 1 11 5 5 5 5 11 1 1 0
1 2 2 2 1 1 1 2 2 2 1
8 5 11 5 1 1 5 11 5 8 0
0 1 2 2 2 8 2 2 2 1 0
0 3 1 1 0 0 1 1 3 0 0
0 0 3 3 0 0 0 3 3 0 0
0 0 0 0 0 0 0 0 0 0 0
0 0 0 0 0 0 0 0 0 0 0
0 0 0 0 0 0 0 0 0 0 0
0 0 0 0 0 0 0 0 0 0 0
0 0 0 0 0 0 0 0 0 0 0
0 0 0 0 0 0 0 0 0 0 0
0 0 0 0 0 0 0 0 0 0 0
0 0 0 0 0 0 0 0 0 0 0
0 0 0 0 0 0 0 0 0 0 0
0 0 0 0 0 0 0 0 0 0 0
0 0 0 0 0 0 0 0 0 0 0
0 0 0 0 0 0 0 0 0 0 0
0 0 0 0 0 0 0 0 0 0 0
0 0 0 0 0 0 0 0 0 0 0
0 0 0 0 0 0 0 0 0 0 0
0 0 0 0 0 0 0 0 0 0 0
0 0 0 0 0 0 0 0 0 0 0
0 0 0 0 0 0 0 0 0 0 0