BotData 5-8-0-750-62-80-4800-12000-1
MODE 0
SIZE 11/30
LIMIT 0/35
COLOR LIMIT 5
STARS 800/1600/2100
6 6 1 1 1 6-BGum-1 3 3 6 6 6
5 5 1 2 1 3 2 3 5 5 0
5 4 0 0 2 2 2 0 0 2 5
4 4 0 0 3 3 0 0 2 2 0
0 4 1 0 3 11 3 0 1 2 0
0 1 2 0 2 4 0 4 1 0 0
0 0 1 2 2 0 4 4 1 0 0
0 0 0 0 0 0 0 0 0 0 0
0 0 0 0 0 0 0 0 0 0 0
0 0 0 0 0 0 0 0 0 0 0
0 0 0 0 0 0 0 0 0 0 0
0 0 0 0 0 0 0 0 0 0 0
0 0 0 0 0 0 0 0 0 0 0
0 0 0 0 0 0 0 0 0 0 0
0 0 0 0 0 0 0 0 0 0 0
0 0 0 0 0 0 0 0 0 0 0
0 0 0 0 0 0 0 0 0 0 0
0 0 0 0 0 0 0 0 0 0 0
0 0 0 0 0 0 0 0 0 0 0
0 0 0 0 0 0 0 0 0 0 0
0 0 0 0 0 0 0 0 0 0 0
0 0 0 0 0 0 0 0 0 0 0
0 0 0 0 0 0 0 0 0 0 0
0 0 0 0 0 0 0 0 0 0 0
0 0 0 0 0 0 0 0 0 0 0
0 0 0 0 0 0 0 0 0 0 0
0 0 0 0 0 0 0 0 0 0 0
0 0 0 0 0 0 0 0 0 0 0
0 0 0 0 0 0 0 0 0 0 0
0 0 0 0 0 0 0 0 0 0 0