BotData 3-7-0-1100-42-85-7500-15800-1
MODE 0
SIZE 11/30
LIMIT 0/32
COLOR LIMIT 5
STARS 1200/2800/4200
3 3 1 3 3 1 3 3 1 3 3
6 1 1 4 1 1 4 1 1 6 0
0 1 3 4 0 3 0 4 3 1 0
1 3 4 3 1 1 3 4 3 1 0
0 3 5 5 0 12 0 5 5 3 0
10 3 4 4 0 0 4 4 3 10 0
0 1 3 0 0 0 0 0 3 1 0
1 8 2 0 4 4 0 2 8 1 0
0 1 2 0 4 0 4 0 2 1 0
0 4 2 0 5 5 0 2 4 0 0
0 0 4 8 5 11 5 8 4 0 0
0 0 0 9 0 0 9 0 0 0 0
0 0 0 6 0 0 0 6 0 0 0
0 0 9 0 0 0 0 9 0 0 0
0 0 0 6 0 0 0 6 0 0 0
0 0 0 9 9 9 9 0 0 0 0
0 0 0 0 0 0 0 0 0 0 0
0 0 0 0 0 0 0 0 0 0 0
0 0 0 0 0 0 0 0 0 0 0
0 0 0 0 0 0 0 0 0 0 0
0 0 0 0 0 0 0 0 0 0 0
0 0 0 0 0 0 0 0 0 0 0
0 0 0 0 0 0 0 0 0 0 0
0 0 0 0 0 0 0 0 0 0 0
0 0 0 0 0 0 0 0 0 0 0
0 0 0 0 0 0 0 0 0 0 0
0 0 0 0 0 0 0 0 0 0 0
0 0 0 0 0 0 0 0 0 0 0
0 0 0 0 0 0 0 0 0 0 0
0 0 0 0 0 0 0 0 0 0 0