BotData 3-5-800-1000-27-45-6000-12500-1
MODE 0
SIZE 11/30
LIMIT 0/15
COLOR LIMIT 3
STARS 1500/2500/3800
1 3 3 5 1 1 1 5 3 3 1
1 3 3 5 5 5 5 3 3 1 0
0 1 5 1 3 3 3 1 5 1 0
0 3 5 1 1 1 1 5 3 0 0
0 0 3 5 1 1 1 5 3 0 0
0 0 3 5 5 5 5 3 0 0 0
0 0 0 3 3 3 3 3 0 0 0
0 0 0 5 5 5 5 0 0 0 0
0 0 0 0 1 1 1 0 0 0 0
0 0 0 0 1 1 0 0 0 0 0
0 0 0 0 0 1 0 0 0 0 0
0 0 0 0 0 0 0 0 0 0 0
0 0 0 0 0 0 0 0 0 0 0
0 0 0 0 0 0 0 0 0 0 0
0 0 0 0 0 0 0 0 0 0 0
0 0 0 0 0 0 0 0 0 0 0
0 0 0 0 0 0 0 0 0 0 0
0 0 0 0 0 0 0 0 0 0 0
0 0 0 0 0 0 0 0 0 0 0
0 0 0 0 0 0 0 0 0 0 0
0 0 0 0 0 0 0 0 0 0 0
0 0 0 0 0 0 0 0 0 0 0
0 0 0 0 0 0 0 0 0 0 0
0 0 0 0 0 0 0 0 0 0 0
0 0 0 0 0 0 0 0 0 0 0
0 0 0 0 0 0 0 0 0 0 0
0 0 0 0 0 0 0 0 0 0 0
0 0 0 0 0 0 0 0 0 0 0
0 0 0 0 0 0 0 0 0 0 0
0 0 0 0 0 0 0 0 0 0 0