BotData 5-15-200-1000-80-120-9000-16000-1
MODE 0
SIZE 11/30
LIMIT 0/42
COLOR LIMIT 5
STARS 2800/4200/6500
Fireball 7-25-2
5 5 6 6 6 6 6 6 6 5 5
5 5 0 0 0 0 0 0 5 5 0
0 1 1 0 0 0 0 0 6 1 0
0 1 5 4 2 2 4 5 1 0 0
0 1 5 3 3 1 1 5 6 1 0
0 5 2 2 2 4 4 4 5 0 0
0 0 3 2 0 0 0 4 3 0 0
0 0 3 3 0 0 3 3 0 0 0
0 0 0 0 3 0 3 0 0 0 0
0 0 0 3 5 5 3 0 0 0 0
0 0 0 0 5 2 5 0 0 0 0
0 0 0 0 2 2 0 0 0 0 0
5 1 1 3 3 12 3 3 1 1 5
10 10 0 0 0 0 0 0 10 10 0
0 5 5 4 4 11 4 4 5 5 0
0 0 4 10 3 2 10 4 0 0 0
0 0 0 10 3 1-BGum-1 2 10 0 0 0
0 0 0 5-Chain-1-1 1 1 5-Chain-1-1 0 0 0 0
9 0 0 0 5-Chain-1-1 5-Chain-1-1 5-Chain-1-1 0 0 0 9
9 0 0 0 6 6 0 0 0 9 0
0 9 9 9 9 9 9 9 9 9 0
0 0 0 0 0 0 0 0 0 0 0