BotData 5-9-0-1100-65-100-8000-12500-1
MODE 0
SIZE 11/30
LIMIT 0/40
COLOR LIMIT 5
STARS 1200/2200/3200
6 6 1 1 6 9 6 1 1 6 6
4 4 5 5 5 5 5 5 4 4 0
4 3 2 2 2 4 2 2 2 3 4
4 3 0 2 4 4 2 0 3 4 0
0 6 3 0 4 11 4 0 6 6 0
0 8 3 1 6 6 1 3 8 0 0
0 0 3 1 5-Chain-2-1 5-Chain-2-1 5-Chain-2-1 1 3 0 0
0 0 4-DoubleColor-5 5-Chain-2-1 0 0 5-Chain-2-1 4-DoubleColor-5 0 0 0
0 0 0 4-DoubleColor-5 3-Chain-1-2 3-Chain-1-2 3-Chain-1-2 4-DoubleColor-5 0 0 0
0 0 0 9 1-DoubleColor-4 1-DoubleColor-4 9 0 0 0 0
0 0 0 0 1-DoubleColor-4 10 1-DoubleColor-4 0 0 0 0
0 0 0 0 9 9 0 0 0 0 0
0 0 0 0 0 9 0 0 0 0 0
0 0 0 0 0 0 0 0 0 0 0
0 0 0 0 0 0 0 0 0 0 0
0 0 0 0 0 0 0 0 0 0 0
0 0 0 0 0 0 0 0 0 0 0
0 0 0 0 0 0 0 0 0 0 0
0 0 0 0 0 0 0 0 0 0 0
0 0 0 0 0 0 0 0 0 0 0
0 0 0 0 0 0 0 0 0 0 0
0 0 0 0 0 0 0 0 0 0 0
0 0 0 0 0 0 0 0 0 0 0
0 0 0 0 0 0 0 0 0 0 0
0 0 0 0 0 0 0 0 0 0 0
0 0 0 0 0 0 0 0 0 0 0
0 0 0 0 0 0 0 0 0 0 0
0 0 0 0 0 0 0 0 0 0 0
0 0 0 0 0 0 0 0 0 0 0
0 0 0 0 0 0 0 0 0 0 0