BotData 5-15-0-500-72-125-4500-30000-1
MODE 0
SIZE 11/30
LIMIT 6/42
COLOR LIMIT 5
STARS 1500/3000/4500
Fireball 7-5-2
Bomb 5-5-4
Multicolor 3-5-7
6 6 6 6 6 6 6 6 6 6 6
6 6 6 6 6 6 6 6 6 6 6
6 6 12 6 6 6 6 6 12 6 6
6 6 6 6 6 6 6 6 6 6 6
6 6 8 6 6 6 6 6 8 6 6
6 6 6 6 6 11 6 6 6 6 6
6 6 6 6 6 6 6 6 6 6 6
6 6 6 6 6 6 6 6 6 6 6
6 6 12 6 6 8 6 6 12 6 6
6 6 6 6 6 6 6 6 6 6 6
6 6 6 6 6 11 6 6 6 6 6
6 6 6 6 6 6 6 6 6 6 6
6 6 6 6 6 6 6 6 6 6 6
6 9 6 9 6 9 6 9 6 9 6
9 6 9 6 9 6 9 6 9 6 9
0 0 0 0 0 0 0 0 0 0 0
0 0 0 0 0 0 0 0 0 0 0
0 0 0 0 0 0 0 0 0 0 0
0 0 0 0 0 0 0 0 0 0 0
0 0 0 0 0 0 0 0 0 0 0
0 0 0 0 0 0 0 0 0 0 0
0 0 0 0 0 0 0 0 0 0 0
0 0 0 0 0 0 0 0 0 0 0
0 0 0 0 0 0 0 0 0 0 0
0 0 0 0 0 0 0 0 0 0 0
0 0 0 0 0 0 0 0 0 0 0
0 0 0 0 0 0 0 0 0 0 0
0 0 0 0 0 0 0 0 0 0 0
0 0 0 0 0 0 0 0 0 0 0
0 0 0 0 0 0 0 0 0 0 0