BotData 4-6-1100-1600-28-42-7200-12000-1
MODE 0
SIZE 11/30
LIMIT 0/10
COLOR LIMIT 3
STARS 800/1200/1800
1 1 3 3 1 1 3 3 5 5 5
0 0 0 0 0 5 0 0 0 0 0
0 0 0 0 1 5 5 1 0 0 0
0 0 0 0 1 5 1 0 0 0 0
0 0 0 0 0 1 1 0 0 0 0
0 0 0 0 0 5 0 0 0 0 0
0 0 0 0 1 5 5 1 0 0 0
0 0 0 0 1 1 1 0 0 0 0
0 0 0 0 0 3 3 0 0 0 0
0 0 0 0 0 3 0 0 0 0 0
0 0 0 0 1 3 3 1 0 0 0
0 0 0 0 1 3 1 0 0 0 0
0 0 0 0 0 5 5 0 0 0 0
0 0 0 0 0 5 0 0 0 0 0
0 0 0 0 3 3 3 3 0 0 0
0 0 0 0 1 3 1 0 0 0 0
0 0 0 0 0 1 1 0 0 0 0
0 0 0 0 0 1 0 0 0 0 0
0 0 0 0 0 0 0 0 0 0 0
0 0 0 0 0 0 0 0 0 0 0
0 0 0 0 0 0 0 0 0 0 0
0 0 0 0 0 0 0 0 0 0 0
0 0 0 0 0 0 0 0 0 0 0
0 0 0 0 0 0 0 0 0 0 0
0 0 0 0 0 0 0 0 0 0 0
0 0 0 0 0 0 0 0 0 0 0
0 0 0 0 0 0 0 0 0 0 0
0 0 0 0 0 0 0 0 0 0 0
0 0 0 0 0 0 0 0 0 0 0
0 0 0 0 0 0 0 0 0 0 0