BotData 3-5-1100-1450-22-38-7200-11000-1
MODE 0
SIZE 11/30
LIMIT 0/17
COLOR LIMIT 3
STARS 1500/2800/4200
1 1 2 0 2 0 2 0 2 1 1
1 0 2 2 0 0 2 2 0 1 0
3 3 2 0 2 1 2 0 2 3 3
3 0 1 1 1 1 1 1 0 3 0
2 2 3 0 3 1 3 0 3 2 2
2 0 3 3 0 0 3 3 0 2 0
1 1 3 0 3 2 3 0 3 1 1
1 0 0 0 2 2 0 0 0 1 0
0 0 0 0 0 2 0 0 0 0 0
0 0 0 0 0 0 0 0 0 0 0
0 0 0 0 0 0 0 0 0 0 0
0 0 0 0 0 0 0 0 0 0 0
0 0 0 0 0 0 0 0 0 0 0
0 0 0 0 0 0 0 0 0 0 0
0 0 0 0 0 0 0 0 0 0 0
0 0 0 0 0 0 0 0 0 0 0
0 0 0 0 0 0 0 0 0 0 0
0 0 0 0 0 0 0 0 0 0 0
0 0 0 0 0 0 0 0 0 0 0
0 0 0 0 0 0 0 0 0 0 0
0 0 0 0 0 0 0 0 0 0 0
0 0 0 0 0 0 0 0 0 0 0
0 0 0 0 0 0 0 0 0 0 0
0 0 0 0 0 0 0 0 0 0 0
0 0 0 0 0 0 0 0 0 0 0
0 0 0 0 0 0 0 0 0 0 0
0 0 0 0 0 0 0 0 0 0 0
0 0 0 0 0 0 0 0 0 0 0
0 0 0 0 0 0 0 0 0 0 0
0 0 0 0 0 0 0 0 0 0 0