BotData 3-5-850-1500-30-40-8500-18000-1
MODE 0
SIZE 11/30
LIMIT 0/18
COLOR LIMIT 3
STARS 1700/2500/4000
4 4 4 3 2 1 3 2 1 3 5
0 4 3 2 1 3 2 1 3 5 0
0 4 3 2 1 3 2 1 3 5 0
4 3 2 1 3 2 1 3 5 0 0
4 3 2 1 3 2 1 3 5 5 5
1 11 3 2 11 3 5 11 4 4 4
0 1 5 3 2 1 3 5 2 4 0
0 1 5 3 2 1 3 5 2 4 0
0 0 1 5 3 2 1 3 5 2 4
1 1 1 5 3 2 1 3 5 2 4
0 0 0 0 0 0 0 0 0 0 0
0 0 0 0 0 0 0 0 0 0 0
0 0 0 0 0 0 0 0 0 0 0
0 0 0 0 0 0 0 0 0 0 0
0 0 0 0 0 0 0 0 0 0 0
0 0 0 0 0 0 0 0 0 0 0
0 0 0 0 0 0 0 0 0 0 0
0 0 0 0 0 0 0 0 0 0 0
0 0 0 0 0 0 0 0 0 0 0
0 0 0 0 0 0 0 0 0 0 0
0 0 0 0 0 0 0 0 0 0 0
0 0 0 0 0 0 0 0 0 0 0
0 0 0 0 0 0 0 0 0 0 0
0 0 0 0 0 0 0 0 0 0 0
0 0 0 0 0 0 0 0 0 0 0
0 0 0 0 0 0 0 0 0 0 0
0 0 0 0 0 0 0 0 0 0 0
0 0 0 0 0 0 0 0 0 0 0
0 0 0 0 0 0 0 0 0 0 0
0 0 0 0 0 0 0 0 0 0 0