BotData 5-8-800-1500-32-48-6500-10000-1
MODE 0
SIZE 11/30
LIMIT 0/22
COLOR LIMIT 5
STARS 2000/3200/4500
6 6 6 6 6 6 6 6 6 6 6
0 0 1 1 1 1 1 0 0 0 0
0 0 2 5 5 5 5 2 0 0 0
0 0 2 2 2 2 2 0 0 0 0
0 0 0 5 2 2 5 0 0 0 0
0 0 0 5 2 5 0 0 0 0 0
0 0 0 1 1 1 1 1 0 0 0
0 0 3 3 3 3 3 3 0 0 0
0 2 2 2 9 9 9 2 2 2 0
2 2 2 0 9 9 0 2 2 2 0
1 1 1 9 0 9 0 9 1 1 1
9 0 9 0 0 0 0 9 0 9 0
0 9 9 0 0 0 0 0 9 9 0
0 0 0 0 0 0 0 0 0 0 0
0 0 0 0 0 0 0 0 0 0 0
0 0 0 0 0 0 0 0 0 0 0
0 0 0 0 0 0 0 0 0 0 0
0 0 0 0 0 0 0 0 0 0 0
0 0 0 0 0 0 0 0 0 0 0
0 0 0 0 0 0 0 0 0 0 0
0 0 0 0 0 0 0 0 0 0 0
0 0 0 0 0 0 0 0 0 0 0
0 0 0 0 0 0 0 0 0 0 0
0 0 0 0 0 0 0 0 0 0 0
0 0 0 0 0 0 0 0 0 0 0
0 0 0 0 0 0 0 0 0 0 0
0 0 0 0 0 0 0 0 0 0 0
0 0 0 0 0 0 0 0 0 0 0
0 0 0 0 0 0 0 0 0 0 0
0 0 0 0 0 0 0 0 0 0 0