BotData 5-8-0-900-48-65-4200-8500-1
MODE 0
SIZE 11/30
LIMIT 0/25
COLOR LIMIT 4
STARS 800/1800/3200
6 6 6 6 6 6 6 6 6 6 6
0 4 0 0 0 0 0 0 1 0 0
0 5 4 6 6 6 6 6 1 5 0
0 5 1 0 0 0 0 3 5 0 0
0 5 0 1 0 0 0 3 0 5 0
5 0 0 1 0 0 3 0 0 5 0
5 10 10 10 1 0 3 10 10 10 5
0 1 1 0 2 2 0 3 3 0 0
0 0 1 0 0 2 0 0 3 0 0
0 6 0 0 6 6 0 0 6 0 0
0 6 0 0 6 0 6 0 0 6 0
0 0 0 0 0 0 0 0 0 0 0
0 0 0 0 0 0 0 0 0 0 0
0 0 0 0 0 0 0 0 0 0 0
0 0 0 0 0 0 0 0 0 0 0
0 0 0 0 0 0 0 0 0 0 0
0 0 0 0 0 0 0 0 0 0 0
0 0 0 0 0 0 0 0 0 0 0
0 0 0 0 0 0 0 0 0 0 0
0 0 0 0 0 0 0 0 0 0 0
0 0 0 0 0 0 0 0 0 0 0
0 0 0 0 0 0 0 0 0 0 0
0 0 0 0 0 0 0 0 0 0 0
0 0 0 0 0 0 0 0 0 0 0
0 0 0 0 0 0 0 0 0 0 0
0 0 0 0 0 0 0 0 0 0 0
0 0 0 0 0 0 0 0 0 0 0
0 0 0 0 0 0 0 0 0 0 0
0 0 0 0 0 0 0 0 0 0 0
0 0 0 0 0 0 0 0 0 0 0