BotData 4-7-0-800-50-65-4000-6500-1
MODE 0
SIZE 11/30
LIMIT 0/25
COLOR LIMIT 5
STARS 1500/2500/3500
3 2 3 2 3 2 3 2 3 2 3
1 1 1 5 5 5 5 1 1 1 0
1 1 0 0 5 5 5 0 0 1 1
1 1 0 0 1 1 0 0 1 1 0
0 1 1 0 0 0 0 0 1 1 0
0 1 3 0 0 0 0 3 1 0 0
0 0 1 3 3 0 3 3 1 0 0
0 0 1 9 9 9 9 1 0 0 0
0 0 8 0 0 0 0 0 8 0 0
0 0 0 0 0 0 0 0 0 0 0
0 0 0 0 0 0 0 0 0 0 0
0 0 0 0 0 0 0 0 0 0 0
0 0 0 0 0 0 0 0 0 0 0
0 0 0 0 0 0 0 0 0 0 0
0 0 0 0 0 0 0 0 0 0 0
0 0 0 0 0 0 0 0 0 0 0
0 0 0 0 0 0 0 0 0 0 0
0 0 0 0 0 0 0 0 0 0 0
0 0 0 0 0 0 0 0 0 0 0
0 0 0 0 0 0 0 0 0 0 0
0 0 0 0 0 0 0 0 0 0 0
0 0 0 0 0 0 0 0 0 0 0
0 0 0 0 0 0 0 0 0 0 0
0 0 0 0 0 0 0 0 0 0 0
0 0 0 0 0 0 0 0 0 0 0
0 0 0 0 0 0 0 0 0 0 0
0 0 0 0 0 0 0 0 0 0 0
0 0 0 0 0 0 0 0 0 0 0